




NO ./texture/bookshelf_01.xpm
SO ./texture/wood.xpm
WE ./texture/wall_4.xpm
EA ./texture/wet_sponge.xpm
F 220,100,0
C 225,30,0

111111111111111111111111
11111110000000000000001111
100100000000000000000011
10010000000000000000011
100000000000000000001111
1111111110110000011110001111
100000000011000001110111111111111
11110111111111011100000010001

11111111111111111111111111111
11110111111111011101010010001
11000000110101011100000010001
10000000000000001111111111111
10000000000N0001101010010001      
110000011101010111111111111111
1111111111111111
11111111111111111111