

NO ./texture/bookshelf_01.xpm
SO ./texture/wood.xpm
WE ./texture/wall_4.xpm
EA ./texture/wet_sponge.xpm
C 43,166,166
F 210,180,140
        1111111111111111111111111
111111111111111001100000000000011111111
        1011000001110000000000001
        1001000000000N00000000001
111111111011000001110000000000001
100000000011000001110111111111111
11110111111111011100000010001
11111111111111111111111111111111
1111111111100000000011000000000111
11111111111111111111111111111111
11110111111111011101010010001
11000000110101011100000010001
10000000000000001100000000001
10000000000000001101010010001
110000011101010111110111100111
11110111 1110101 101111010001
11111111 1111111 111111111111