
NO ./texture/mycelium_top.xpm
SO ./texture/mycelium_top.xpm
WE ./texture/mycelium_top.xpm
EA ./texture/mycelium_top.xpm
F 220,100,0
C 225,30,0
1111111111111111111111111
1000000000000000000000001
1000000000000000000000001
1000000000000000000000001
1000000000000000000000001
1000000011100111000001101
1011000011100111000000001
10000000000000000000001101
1011000000111100000000001
100000000011E000000000001
10000000000000000000100001
1011000000000000000001101
1000000000000000000000001
1000000000000000000000001
1111111111111111111111111