
NO ./texture/netherrack.xpm
SO ./texture/netherrack_01.xpm
WE ./texture/netherrack_02.xpm
EA ./texture/netherrack.xpm
F 220,100,0
C 225,30,0
1111
1001
1N1
1001
1101 
  000000  
  0000000000
  